10 5
##########
#   T    #
#    @   #
# T      #
##########